A.ADM1	primær administrativ inndeling	a primary administrative division of a country, such as a state in the United States
A.ADM2	sekundær administrativ inndeling	a subdivision of a first-order administrative division
A.ADM3	administrativ inndeling av tredje grad	a subdivision of a second-order administrative division
A.ADM4	administrativ inndeling av fjerde grad 	a subdivision of a third-order administrative division
A.ADMD	administrativ inndeling	an administrative division of a country, undifferentiated as to administrative level
A.LTER	leid landområde	a tract of land leased by the United Kingdom from the People's Republic of China to form part of Hong Kong
A.PCL	politisk enhet	
A.PCLD	avhengig politisk enhet	
A.PCLF	fritt tilknyttet stat	
A.PCLI	uavhengig politisk enhet	
A.PCLIX	del av uavhengig politisk enhet	
A.PCLS	delvis uavhengig politisk enhet	
A.PRSH	sogn	an ecclesiastical district
A.TERR	territorium	
A.ZN	sone	
A.ZNB	buffersone	a zone recognized as a buffer between two nations in which military presence is minimal or absent
H.AIRS	landingsområde for sjøfly	a place on a waterbody where floatplanes land and take off
H.ANCH	ankerplass	an area where vessels may anchor
H.BAY	bukt	a coastal indentation between two capes or headlands, larger than a cove but smaller than a gulf
H.BAYS	bukter	coastal indentations between two capes or headlands, larger than a cove but smaller than a gulf
H.BGHT	vik	an open body of water forming a slight recession in a coastline
H.BNK	banker	an elevation, typically located on a shelf, over which the depth of water is relatively shallow but sufficient for most surface navigation
H.BNKR	elvebredd	a sloping margin of a stream channel which normally confines the stream to its channel on land
H.BNKX	del av bredd	
H.BOG	myr	a wetland characterized by peat forming sphagnum moss, sedge, and other acid-water plants
H.CAPG	iskappe	a dome-shaped mass of glacial ice covering an area of mountain summits or other high lands; smaller than an ice sheet
H.CHN	kanal	the deepest part of a stream, bay, lagoon, or strait, through which the main current flows
H.CHNL	seilingskanal i innsjø	that part of a lake having water deep enough for navigation between islands, shoals, etc.
H.CHNM	skipsled på sjøen	that part of a body of water deep enough for navigation through an area otherwise not suitable
H.CHNN	merket skipsled	a buoyed channel of sufficient depth for the safe navigation of vessels
H.CNFL	sammenløp	a place where two or more streams or intermittent streams flow together
H.CNL	kanal	an artificial watercourse
H.CNLA	akvedukt	a conduit used to carry water
H.CNLB	kanalsving	a conspicuously curved or bent section of a canal
H.CNLD	dreneringskanal	an artificial waterway carrying water away from a wetland or from drainage ditches
H.CNLI	vanningskanal	a canal which serves as a main conduit for irrigation water
H.CNLN	seilingskanal	a watercourse constructed for navigation of vessels
H.CNLQ	nedlagt kanal	
H.CNLSB	underjordisk vanningskanal	a gently inclined underground tunnel bringing water for irrigation from aquifers
H.CNLX	del av kanal	
H.COVE	kil	a small coastal indentation, smaller than a bay
H.CRKT	tidevannselv	a meandering channel in a coastal wetland subject to bi-directional tidal currents
H.CRNT	strøm	a horizontal flow of water in a given direction with uniform velocity
H.CUTF	avskåret	a channel formed as a result of a stream cutting through a meander neck
H.DCK	dokk	a waterway between two piers, or cut into the land for the berthing of ships
H.DCKB	havnebasseng	a part of a harbor where ships dock
H.DOMG	iskuppel	a comparatively elevated area on an icecap
H.DPRG	fordypning i iskappen	a comparatively depressed area on an icecap
H.DTCH	grøft	a small artificial watercourse dug for draining or irrigating the land
H.DTCHD	dreneringsgrøft	a ditch which serves to drain the land
H.DTCHI	vanningsgrøft	a ditch which serves to distribute irrigation water
H.DTCHM	grøfteutløp	an area where a drainage ditch enters a lagoon, lake or bay
H.ESTY	elvemunning	a funnel-shaped stream mouth or embayment where fresh water mixes with sea water under tidal influences
H.FISH	fiskeområde	a fishing ground, bank or area where fishermen go to catch fish
H.FJD	fjord	a long, narrow, steep-walled, deep-water arm of the sea at high latitudes, usually along mountainous coasts
H.FJDS	fjorder	long, narrow, steep-walled, deep-water arms of the sea at high latitudes, usually along mountainous coasts
H.FLLS	foss	a perpendicular or very steep descent of the water of a stream
H.FLLSX	del av foss	
H.FLTM	slamområde	a relatively level area of mud either between high and low tide lines, or subject to flooding
H.FLTT	tidevannsområde	a large flat area of mud or sand attached to the shore and alternately covered and uncovered by the tide
H.GLCR	isbre	a mass of ice, usually at high latitudes or high elevations, with sufficient thickness to flow away from the source area in lobes, tongues, or masses
H.GULF	golf	a large recess in the coastline, larger than a bay
H.GYSR	geysir	a type of hot spring with intermittent eruptions of jets of hot water and steam
H.HBR	havn	a haven or space of deep water so sheltered by the adjacent land as to afford a safe anchorage for ships
H.HBRX	del av havn	
H.INLT	innløp	a narrow waterway extending into the land, or connecting a bay or lagoon with a larger body of water
H.INLTQ	tidligere innløp	an inlet which has been filled in, or blocked by deposits
H.LBED	gammel innsjøbunn	a dried up or drained area of a former lake
H.LGN	lagune	a shallow coastal waterbody, completely or partly separated from a larger body of water by a barrier island, coral reef or other depositional feature
H.LGNS	laguner	shallow coastal waterbodies, completely or partly separated from a larger body of water by a barrier island, coral reef or other depositional feature
H.LGNX	del av lagune	
H.LK	innsjø 	a large inland body of standing water
H.LKC	kratersjø	a lake in a crater or caldera
H.LKI	tilbakevendende innsjø	
H.LKN	saltsjø	an inland body of salt water with no outlet
H.LKNI	tilbakevendende saltsjø	
H.LKO	kroksjø	a crescent-shaped lake commonly found adjacent to meandering streams
H.LKOI	tilbakevendende kroksjø	
H.LKS	innsjøer	large inland bodies of standing water
H.LKSB	underjordisk innsjø	a standing body of water in a cave
H.LKSC	kratersjøer	lakes in a crater or caldera
H.LKSI	tilbakevendende innsjøer	
H.LKSN	saltsjøer	inland bodies of salt water with no outlet
H.LKSNI	tilbakevendende saltsjøer	
H.LKX	del av innsjø	
H.MFGN	saltutvinningsbasseng	diked salt ponds used in the production of solar evaporated salt
H.MGV	mangrovesump	a tropical tidal mud flat characterized by mangrove vegetation
H.MOOR	mo	an area of open ground overlaid with wet peaty soils
H.MRSH	myr	a wetland dominated by grass-like vegetation
H.MRSHN	marskland	a flat area, subject to periodic salt water inundation, dominated by grassy salt-tolerant plants
H.NRWS	smale sund	a navigable narrow part of a bay, strait, river, etc.
H.OCN	hav	one of the major divisions of the vast expanse of salt water covering part of the earth
H.OVF	brenninger	an area of breaking waves caused by the meeting of currents or by waves moving against the current
H.PND	tjern	a small standing waterbody
H.PNDI	tilbakevendende tjern	
H.PNDN	saltvannsdam	a small standing body of salt water often in a marsh or swamp, usually along a seacoast
H.PNDNI	tilbakevendende saltvannsdam	
H.PNDS	dammer	small standing waterbodies
H.PNDSF	fiskedammer	ponds or enclosures in which fish are kept or raised
H.PNDSI	tilbakevendende dammer	
H.PNDSN	saltvannsdammer	small standing bodies of salt water often in a marsh or swamp, usually along a seacoast
H.POOL	kulp	a small and comparatively still, deep part of a larger body of water such as a stream or harbor; or a small body of standing water
H.POOLI	tilbakevendende kulp	
H.RCH	rett elve- eller kanalstrekning	a straight section of a navigable stream or channel between two bends
H.RDGG	iskapperygg	a linear elevation on an icecap
H.RDST	åpen ankerplass	an open anchorage affording less protection than a harbor
H.RF	rev	a surface-navigation hazard composed of consolidated material
H.RFC	korallrev	a surface-navigation hazard composed of coral
H.RFX	del av rev	
H.RPDS	stryk	a turbulent section of a stream associated with a steep, irregular stream bed
H.RSV	reservoar	an artificial pond or lake
H.RSVI	tilbakevendende reservoar	
H.RSVT	vanntank	a contained pool or tank of water at, below, or above ground level
H.RVN	ravine	a small, narrow, deep, steep-sided stream channel, smaller than a gorge
H.SBKH	sabkha (oversvømt område)	a salt flat or salt encrusted plain subject to periodic inundation from flooding or high tides
H.SD	sund	a long arm of the sea forming a channel between the mainland and an island or islands; or connecting two larger bodies of water
H.SEA	sjø 	a large body of salt water more or less confined by continuous land or chains of islands forming a subdivision of an ocean
H.SHOL	sandgrunne	a surface-navigation hazard composed of unconsolidated material
H.SILL	terskel	the low part of an underwater gap or saddle separating basins, including a similar feature at the mouth of a fjord
H.SPNG	kilde	a place where ground water flows naturally out of the ground
H.SPNS	svovelkilde	a place where sulphur ground water flows naturally out of the ground
H.SPNT	varm kilde	a place where hot ground water flows naturally out of the ground
H.STM	bekk	a body of running water moving to a lower level in a channel on land
H.STMA	elvearm som vender tilbake til hovedløpet	a diverging branch flowing out of a main stream and rejoining it downstream
H.STMB	elvesving	a conspicuously curved or bent segment of a stream
H.STMC	kanalisert bekk	a stream that has been substantially ditched, diked, or straightened
H.STMD	flodarm som ikke vender tilbake til hovedløpet	a branch which flows away from the main stream, as in a delta or irrigation canal
H.STMH	utspring	the source and upper part of a stream, including the upper drainage basin
H.STMI	tilbakevendende bekk	
H.STMIX	del av tilbakevendende bekk	
H.STMM	bekkeutløp	a place where a stream discharges into a lagoon, lake, or the sea
H.STMQ	inntørket elveleie	a former stream or distributary no longer carrying flowing water, but still evident due to lakes, wetland, topographic or vegetation patterns
H.STMS	bekker	bodies of running water moving to a lower level in a channel on land
H.STMSB	elv uten utløp	a surface stream that disappears into an underground channel, or dries up in an arid area
H.STMX	del av bekk	
H.STRT	sund	a relatively narrow waterway, usually narrower and less extensive than a sound, connecting two larger bodies of water
H.SWMP	sump	a wetland dominated by tree vegetation
H.SYSI	vanningssystem	a network of ditches and one or more of the following elements: water supply, reservoir, canal, pump, well, drain, etc.
H.TNLC	kanaltunnel	a tunnel through which a canal passes
H.WAD	wadi	a valley or ravine, bounded by relatively steep banks, which in the rainy season becomes a watercourse; found primarily in North Africa and the Middle East
H.WADB	wadi-sving	a conspicuously curved or bent segment of a wadi
H.WADJ	wadi-sammenløp	a place where two or more wadies join
H.WADM	wadi-utløp	the lower terminus of a wadi where it widens into an adjoining floodplain, depression, or waterbody
H.WADS	wadier	valleys or ravines, bounded by relatively steep banks, which in the rainy season become watercourses; found primarily in North Africa and the Middle East
H.WADX	del av wadi	
H.WHRL	strømvirvel	a turbulent, rotating movement of water in a stream
H.WLL	brønn	a cylindrical hole, pit, or tunnel drilled or dug down to a depth from which water, oil, or gas can be pumped or brought to the surface
H.WLLQ	forlatt brønn	
H.WLLS	brønner	cylindrical holes, pits, or tunnels drilled or dug down to a depth from which water, oil, or gas can be pumped or brought to the surface
H.WTLD	våtmark	an area subject to inundation, usually characterized by bog, marsh, or swamp vegetation
H.WTLDI	tilbakevendende våtmark	
H.WTRC	vannløp	a natural, well-defined channel produced by flowing water, or an artificial channel designed to carry flowing water
H.WTRH	vannhull	a natural hole, hollow, or small depression that contains water, used by man and animals, especially in arid areas
L.AGRC	landbrukskoloni	a tract of land set aside for agricultural settlement
L.AMUS	amusement park	Amusement Park are theme parks, adventure parks offering entertainment, similar to funfairs but with a fix location
L.AREA	område	a tract of land without homogeneous character or boundaries
L.BSND	dreneringsbasseng	an area drained by a stream
L.BSNP	petroleumsbasseng	an area underlain by an oil-rich structural basin
L.BTL	slagmark	a site of a land battle of historical importance
L.CLG	lysning	an area in a forest with trees removed
L.CMN	allmenning	a park or pasture for community use
L.CNS	konsesjonsområde	a lease of land by a government for economic development, e.g., mining, forestry
L.COLF	kullfelt	a region in which coal deposits of possible economic value occur
L.CONT	kontinent	continent : Europe, Africa, Asia, North America, South America, Oceania,Antarctica
L.CST	kyst	a zone of variable width straddling the shoreline
L.CTRB	forretningssenter	a place where a number of businesses are located
L.DEVH	boligområde	a tract of land on which many houses of similar design are built according to a development plan
L.FLD	åker	an open as opposed to wooded area
L.FLDI	overrislet åker	a tract of level or terraced land which is irrigated
L.GASF	gassfelt	an area containing a subterranean store of natural gas of economic value
L.GRAZ	beiteområde	an area of grasses and shrubs used for grazing
L.GVL	grusområde	an area covered with gravel
L.INDS	industriområde	an area characterized by industrial activity
L.LAND	arktisk landskap	a tract of land in the Arctic
L.LCTY	trakt	a minor area or place of unspecified or mixed character and indefinite boundaries
L.MILB	militærbase	a place used by an army or other armed service for storing arms and supplies, and for accommodating and training troops, a base from which operations can be initiated
L.MNA	gruveområde	an area of mine sites where minerals and ores are extracted
L.MVA	militært treningsområde	a tract of land where military field exercises are carried out
L.NVB	marinebase	an area used to store supplies, provide barracks for troops and naval personnel, a port for naval vessels, and from which operations are initiated
L.OAS	oase	an area in a desert made productive by the availability of water
L.OILF	oljefelt	an area containing a subterranean store of petroleum of economic value
L.PEAT	torvskjæringsområde	an area where peat is harvested
L.PRK	park	an area, often of forested land, maintained as a place of beauty, or for recreation
L.PRT	havn	a place provided with terminal and transfer facilities for loading and discharging waterborne cargo or passengers, usually located in a harbor
L.QCKS	kvikksand	an area where loose sand with water moving through it may become unstable when heavy objects are placed at the surface, causing them to sink
L.REP	republikk	
L.RES	regulert område	a tract of public land reserved for future use or restricted as to use
L.RESA	område regulert til landbruk	a tract of land reserved for agricultural reclamation and/or development
L.RESF	vernet skog	a forested area set aside for preservation or controlled use
L.RESH	jaktområde	a tract of land used primarily for hunting
L.RESN	naturreservat	an area reserved for the maintenance of a natural habitat
L.RESP	palmereservat	an area of palm trees where use is controlled
L.RESV	reservat	a tract of land set aside for aboriginal, tribal, or native populations
L.RESW	viltreservat	a tract of public land reserved for the preservation of wildlife
L.RGN	region	an area distinguished by one or more observable physical or cultural characteristics
L.RGNE	økonomisk region	a region of a country established for economic development or for statistical purposes
L.RGNL	innsjøområde	a tract of land distinguished by numerous lakes
L.RNGA	militært skytefelt	a tract of land used for artillery firing practice
L.SALT	saltområde	a shallow basin or flat where salt accumulates after periodic inundation
L.SNOW	snødekt område	an area of permanent snow and ice forming the accumulation area of a glacier
L.TRB	stammeområde	a tract of land used by nomadic or other tribes
L.ZZZZZ	master-liste for kildesamling	
P.PPL	befolket sted	a city, town, village, or other agglomeration of buildings where people live and work
P.PPLA	sete for primær administrativ inndeling	seat of a first-order administrative division (PPLC takes precedence over PPLA)
P.PPLA2	seat of a second-order administrative division	
P.PPLA3	seat of a third-order administrative division	
P.PPLA4	seat of a fourth-order administrative division	
P.PPLC	Hovedstad	
P.PPLF	farm village	a populated place where the population is largely engaged in agricultural activities
P.PPLG	regjeringssete i en politisk enhet	
P.PPLL	befolket trakt	an area similar to a locality but with a small group of dwellings or other buildings
P.PPLQ	avfolket sted	
P.PPLR	religiøst befolket sted	a populated place whose population is largely engaged in religious occupations
P.PPLS	befolkede steder	cities, towns, villages, or other agglomerations of buildings where people live and work
P.PPLW	ødelagt befolket sted	a village, town or city destroyed by a natural disaster, or by war
P.PPLX	del av befolket sted	
P.STLMT	israelsk bosetning	
R.CSWY	veifylling	a raised roadway across wet ground or shallow water
R.CSWYQ	tidligere veifylling	a causeway no longer used for transportation
R.OILP	oljeledning	a pipeline used for transporting oil
R.PRMN	promenade	a place for public walking, usually along a beach front
R.PTGE	eid	a place where boats, goods, etc., are carried overland between navigable waters
R.RD	vei	an open way with improved surface for transportation of animals, people and vehicles
R.RDA	gammel vei	the remains of a road used by ancient cultures
R.RDB	veikurve	a conspicuously curved or bent section of a road
R.RDCUT	veiskjæring	an excavation cut through a hill or ridge for a road
R.RDJCT	veikryss	a place where two or more roads join
R.RJCT	jernbanekryss	a place where two or more railroad tracks join
R.RR	jernbane	a permanent twin steel-rail track on which freight and passenger cars move long distances
R.RRQ	nedlagt jernbane	
R.RTE	karavanerute	the route taken by caravans
R.RYD	jernbaneområde	a system of tracks used for the making up of trains, and switching and storing freight cars
R.ST	gate	a paved urban thoroughfare
R.STKR	rute for krøtterdrift	a route taken by livestock herds
R.TNL	tunnel	a subterranean passageway for transportation
R.TNLN	naturlig tunnel	a cave that is open at both ends
R.TNLRD	veitunnel	a tunnel through which a road passes
R.TNLRR	jernbanetunnel	a tunnel through which a railroad passes
R.TNLS	tunneler	subterranean passageways for transportation
R.TRL	sti	a path, track, or route used by pedestrians, animals, or off-road vehicles
S.ADMF	administrasjonsanlegg	a government building
S.AGRF	jordbruksanlegg	a building and/or tract of land used for improving agriculture
S.AIRB	flybase	an area used to store supplies, provide barracks for air force personnel, hangars and runways for aircraft, and from which operations are initiated
S.AIRF	flyplass	a place on land where aircraft land and take off; no facilities provided for the commercial handling of passengers and cargo
S.AIRH	heliport	a place where helicopters land and take off
S.AIRP	lufthavn	a place where aircraft regularly land and take off, with runways, navigational aids, and major facilities for the commercial handling of passengers and cargo
S.AIRQ	forlatt lufthavn	
S.AMTH	amfiteater	an oval or circular structure with rising tiers of seats about a stage or open space
S.ANS	historisk sted	a place where archeological remains, old structures, or cultural artifacts are located
S.ARCH	bue	a natural or man-made structure in the form of an arch
S.ASTR	astronomisk stasjon	a point on the earth whose position has been determined by observations of celestial bodies
S.ASYL	asyl	a facility where the insane are cared for and protected
S.ATHF	idrettsbane	a tract of land used for playing team sports, and athletic track and field events
S.ATM	automatic teller machine	An unattended electronic machine in a public place, connected to a data system and related equipment and activated by a bank customer to obtain cash withdrawals and other banking services. 
S.BANK	bank	A business establishment in which money is kept for saving or commercial purposes or is invested, supplied for loans, or exchanged. 
S.BCN	signalstasjon	a fixed artificial navigation mark
S.BDG	bro	a structure erected across an obstacle such as a stream, road, etc., in order to carry roads, railroads, and pedestrians across
S.BDGQ	ødelagt bro	a destroyed or decayed bridge which is no longer functional
S.BLDG	bygning	a structure built for permanent use, as a house, factory, etc.
S.BP	grensemarkør	a fixture marking a point along a boundary
S.BRKS	brakker	a building for lodging military personnel
S.BRKW	bølgebryter	a structure erected to break the force of waves at the entrance to a harbor or port
S.BSTN	ballestasjon	a facility for baling agricultural products
S.BTYD	verft	a waterside facility for servicing, repairing, and building small vessels
S.BUR	gravhule	a cave used for human burials
S.BUSTN	Bus Station	a facility comprising ticket office, platforms, etc. for loading and unloading passengers 
S.BUSTP	Bus Stop	a place lacking station facilities
S.CARN	varde	a heap of stones erected as a landmark or for other purposes
S.CAVE	grotte	an underground passageway or chamber, or cavity on the side of a cliff
S.CCL	Centre Continuous Learning	Centres for Continuous Learning
S.CH	kirke	a building for public Christian worship
S.CMP	leir	a site occupied by tents, huts, or other shelters for temporary use
S.CMPL	tømmerkoie	a camp used by loggers
S.CMPLA	arbeidsleir	a camp used by migrant or temporary laborers
S.CMPMN	gruveleir	a camp used by miners
S.CMPO	oljeleir	a camp used by oilfield workers
S.CMPQ	forlatt leir	
S.CMPRF	flyktningleir	a camp used by refugees
S.CMTY	gravlund	a burial place or ground
S.COMC	kommunikasjonssenter	a facility, including buildings, antennae, towers and electronic equipment for receiving and transmitting information
S.CRRL	innhegning	a pen or enclosure for confining or capturing animals
S.CSNO	kasino	a building used for entertainment, especially gambling
S.CSTL	slott	a large fortified building or set of buildings
S.CSTM	tollbod	a building in a port where customs and duties are paid, and where vessels are entered and cleared
S.CTHSE	rettsbygning	a building in which courts of law are held
S.CTRA	atomsenter	a facility where atomic research is carried out
S.CTRCM	kommunesenter	a facility for community recreation and other activities
S.CTRF	tjenestesenter	a place where more than one facility is situated
S.CTRM	legesenter	a complex of health care buildings including two or more of the following: hospital, medical school, clinic, pharmacy, doctor's offices, etc.
S.CTRR	religiøst senter	a facility where more than one religious activity is carried out, e.g., retreat, school, monastery, worship
S.CTRS	romsenter	a facility for launching, tracking, or controlling satellites and space vehicles
S.CVNT	kloster	a building where a community of nuns lives in seclusion
S.DAM	demning	a barrier constructed across a stream to impound water
S.DAMQ	ødelagt demning	a destroyed or decayed dam which is no longer functional
S.DAMSB	demning gravd ned til grunnfjellet	a dam put down to bedrock in a sand river
S.DARY	meieri	a facility for the processing, sale and distribution of milk or milk products
S.DCKD	demning gravd ned til grunnfjellet	a dock providing support for a vessel, and means for removing the water so that the bottom of the vessel can be exposed
S.DCKY	skipsverft	a facility for servicing, building, or repairing ships
S.DIKE	dike	an earth or stone embankment usually constructed for flood or stream control
S.DPOF	brennstofflager	an area where fuel is stored
S.EST	gods	a large commercialized agricultural landholding with associated buildings and other facilities
S.ESTB	bananplantasje	an estate that specializes in the growing of bananas
S.ESTC	bomullsplantasje	an estate specializing in the cultivation of cotton
S.ESTO	oljepalmeplantasje	an estate specializing in the cultivation of oil palm trees
S.ESTR	gummiplantasje	an estate which specializes in growing and tapping rubber trees
S.ESTSG	sukkerplantasje	an estate that specializes in growing sugar cane
S.ESTSL	sisalplantasje	an estate that specializes in growing sisal
S.ESTT	teplantasje	an estate which specializes in growing tea bushes
S.ESTX	del av gods	
S.FCL	anlegg	a building or buildings housing a center, institute, foundation, hospital, prison, mission, courthouse, etc.
S.FNDY	støperi	a building or works where metal casting is carried out
S.FRM	gård	a tract of land with associated buildings devoted to agriculture
S.FRMQ	forlatt gård 	
S.FRMS	gårder	tracts of land with associated buildings devoted to agriculture
S.FRMT	gårdsbruk	the buildings and adjacent service areas of a farm
S.FT	fort	a defensive structure or earthworks
S.FY	ferge	a boat or other floating conveyance and terminal facilities regularly used to transport people and vehicles across a waterbody
S.GATE	grind	a controlled access entrance or exit
S.GDN	hage	an enclosure for displaying selected plant or animal life
S.GHSE	gjestehus	a house used to provide lodging for paying guests
S.GOSP	separasjonsanlegg for gass og olje	a facility for separating gas from oil
S.GRVE	grav	a burial site
S.HERM	eneboerhytte	a secluded residence, usually for religious sects
S.HLT	stoppested	a place where caravans stop for rest
S.HSE	hus	a building used as a human habitation
S.HSEC	landsted	a large house, mansion, or chateau, on a large estate
S.HSP	sykehus	a building in which sick or injured, especially those confined to bed, are medically treated
S.HSPC	klinikk	a medical facility associated with a hospital for outpatients
S.HSPD	apotek	a building where medical or dental aid is dispensed
S.HSPL	leprasykehus	an asylum or hospital for lepers
S.HSTS	historisk sted	a place of historical importance
S.HTL	hotell	a building providing lodging and/or meals for the public
S.HUT	hytte	a small primitive house
S.HUTS	hytter	small primitive houses
S.INSM	militæranlegg	a facility for use of and control by armed forces
S.ITTR	forskningsinstitutt	a facility where research is carried out
S.JTY	molo	a structure built out into the water at a river mouth or harbor entrance to regulate currents and silting
S.LDNG	kai	a place where boats receive or discharge passengers and freight, but lacking most port facilities
S.LEPC	leprakoloni	a settled area inhabited by lepers in relative isolation
S.LIBR	library	A place in which information resources such as books are kept for reading, reference, or lending.
S.LNDF	landfill	a place for trash and garbage disposal in which the waste is buried between layers of earth to build up low-lying land
S.LOCK	sluse	a basin in a waterway with gates at each end by means of which vessels are passed from one water level to another
S.LTHSE	fyrtårn	a distinctive structure exhibiting a major navigation light
S.MALL	kjøpesenter	A large, often enclosed shopping complex containing various stores, businesses, and restaurants usually accessible by common passageways.
S.MAR	småbåthavn	a harbor facility for small boats, yachts, etc.
S.MFG	fabrikk	one or more buildings where goods are manufactured, processed or fabricated
S.MFGB	bryggeri	one or more buildings where beer is brewed
S.MFGC	hermetikkfabrikk	a building where food items are canned
S.MFGCU	kopperverk	a facility for processing copper ore
S.MFGLM	kalkbrenneri	a furnace in which limestone is reduced to lime
S.MFGM	ammunisjonsfabrikk	a factory where ammunition is made
S.MFGPH	fosfatanlegg	a facility for producing fertilizer
S.MFGQ	nedlagt fabrikk	
S.MFGSG	sukkerraffineri	a facility for converting raw sugar into refined sugar
S.MKT	marked	a place where goods are bought and sold at regular intervals
S.ML	mølle	a building housing machines for transforming, shaping, finishing, grinding, or extracting products
S.MLM	malmbehandlingsanlegg	a facility for improving the metal content of ore by concentration
S.MLO	olivenoljemølle	a mill where oil is extracted from olives
S.MLSG	sukkermølle	a facility where sugar cane is processed into raw sugar
S.MLSGQ	tidligere sukkermølle	a sugar mill no longer used as a sugar mill
S.MLSW	sagbruk	a mill where logs or lumber are sawn to specified shapes and sizes
S.MLWND	vindmølle	a mill or water pump powered by wind
S.MLWTR	kvernhus	a mill powered by running water
S.MN	gruve 	a site where mineral ores are extracted from the ground by excavating surface pits and subterranean passages
S.MNAU	gullgruve	a mine where gold ore, or alluvial gold is extracted
S.MNC	kullgruve	a mine where coal is extracted
S.MNCR	kromgruve	a mine where chrome ore is extracted
S.MNCU	koppergruve	a mine where copper ore is extracted
S.MNDT	diatomittgruve	a place where diatomaceous earth is extracted
S.MNFE	jerngruve	a mine where iron ore is extracted
S.MNMT	monument	a commemorative structure or statue
S.MNN	saltgruve	a mine from which salt is extracted
S.MNNI	nikkelgruve	a mine where nickel ore is extracted
S.MNPB	blygruve	a mine where lead ore is extracted
S.MNPL	gruve med malmførende sand	a place where heavy metals are concentrated and running water is used to extract them from unconsolidated sediments
S.MNQ	nedlagt gruve	
S.MNQR	steinbrudd	a surface mine where building stone or gravel and sand, etc. are extracted
S.MNSN	tinngruve	a mine where tin ore is extracted
S.MOLE	molo	a massive structure of masonry or large stones serving as a pier or breakwater
S.MSQE	moské	a building for public Islamic worship
S.MSSN	misjonsstasjon	a place characterized by dwellings, school, church, hospital and other facilities operated by a religious group for the purpose of providing charitable services and to propagate religion
S.MSSNQ	nedlagt misjonsstasjon	
S.MSTY	kloster	a building and grounds where a community of monks lives in seclusion
S.MTRO	metro station	metro station (Underground, Tube, or Métro) 
S.MUS	museum	a building where objects of permanent interest in one or more of the arts and sciences are preserved and exhibited
S.NOV	novisiat	a religious house or school where novices are trained
S.NSY	barnehage	a place where plants are propagated for transplanting or grafting
S.OBPT	observasjonssted	a wildlife or scenic observation point
S.OBS	observatorium	a facility equipped for observation of atmospheric or space phenomena
S.OBSR	radioobservatorium	a facility equipped with an array of antennae for receiving radio waves from space
S.OILJ	oljeledningsknutepunkt	a section of an oil pipeline where two or more pipes join together
S.OILQ	forlatt oljebrønn	
S.OILR	oljeraffineri	a facility for converting crude oil into refined petroleum products
S.OILT	petrokjemisk anlegg	a tract of land occupied by large, cylindrical, metal tanks in which oil or liquid petrochemicals are stored
S.OILW	oljebrønn	a well from which oil may be pumped
S.OPRA	operahus	A theater designed chiefly for the performance of operas.
S.PAL	palass	a large stately house, often a royal or presidential residence
S.PGDA	pagode	a tower-like storied structure, usually a Buddhist shrine
S.PIER	pir	a structure built out into navigable water on piles providing berthing for ships and recreation
S.PKLT	parkeringsplass	an area used for parking vehicles
S.PMPO	oljepumpestasjon	a facility for pumping oil through a pipeline
S.PMPW	vannpumpestasjon	a facility for pumping water from a major well or through a pipeline
S.PO	postkontor	a public building in which mail is received, sorted and distributed
S.PP	politiforlegning	a building in which police are stationed
S.PPQ	nedlagt politiforlegning	
S.PRKGT	inngang til militæranlegg	a controlled access to a park
S.PRKHQ	hovedkvarter på militæranlegg	a park administrative facility
S.PRN	fengsel	a facility for confining prisoners
S.PRNJ	forbedringsanstalt	a facility for confining, training, and reforming young law offenders
S.PRNQ	nedlagt fengsel	
S.PS	kraftstasjon	a facility for generating electric power
S.PSH	vannkraftverk	a building where electricity is generated from water power
S.PSTB	grensestasjon	a post or station at an international boundary for the regulation of movement of people and goods
S.PSTC	tollstasjon	a building at an international boundary where customs and duties are paid on goods
S.PSTP	patruljepost	a post from which patrols are sent out
S.PYR	pyramide	an ancient massive structure of square ground plan with four triangular faces meeting at a point and used for enclosing tombs
S.PYRS	pyramider	ancient massive structures of square ground plan with four triangular faces meeting at a point and used for enclosing tombs
S.QUAY	brygge 	a structure of solid construction along a shore or bank which provides berthing for ships and which generally provides cargo handling facilities
S.RECG	golfbane	a recreation field where golf is played
S.RECR	veddeløpsbane	a track where races are held
S.REST	restaurant	A place where meals are served to the public
S.RHSE	hvilehjem	a structure maintained for the rest and shelter of travelers
S.RKRY	fuglekoloni	a breeding place of a colony of birds or seals
S.RLG	religiøst sted	an ancient site of significant religious importance
S.RLGR	tilfluktssted	a place of temporary seclusion, especially for religious groups
S.RNCH	ranch	a large farm specializing in extensive grazing of livestock
S.RSD	jernbanesidespor	a short track parallel to and joining the main track
S.RSGNL	jernbanesignal	a signal at the entrance of a particular section of track governing the movement of trains
S.RSRT	feriested	a specialized facility for vacation, health, or participation sports activities
S.RSTN	jernbanestasjon	a facility comprising ticket office, platforms, etc. for loading and unloading train passengers and freight
S.RSTNQ	nedlagt jernbanestasjon	
S.RSTP	jernbanestoppested	a place lacking station facilities where trains stop to pick up and unload passengers and freight
S.RSTPQ	nedlagt jernbanestoppested	
S.RUIN	ruin	a destroyed or decayed structure which is no longer functional
S.SCH	skole	building(s) where instruction in one or more branches of knowledge takes place
S.SCHA	landbruksskole	a school with a curriculum focused on agriculture
S.SCHC	høyskole	the grounds and buildings of an institution of higher learning
S.SCHD	Driving School	Driving School
S.SCHL	Language School	Language Schools & Institutions
S.SCHM	militærskole	a school at which military science forms the core of the curriculum
S.SCHN	sjøfartsskole	a school at which maritime sciences form the core of the curriculum
S.SCHT	technical school	post-secondary school with a specifically technical or vocational curriculum
S.SECP	State Exam Prep Centre	State Exam Preparation Centres
S.SHPF	sauekve	a fence or wall enclosure for sheep and other small herd animals
S.SHRN	helligdom	a structure or place memorializing a person or religious concept
S.SHSE	lagerbygning	a building for storing goods, especially provisions
S.SLCE	sluse	a conduit or passage for carrying off surplus water from a waterbody, usually regulated by means of a sluice gate
S.SNTR	sanatorium	a facility where victims of physical or mental disorders are treated
S.SPA	spa	a resort area usually developed around a medicinal spring
S.SPLY	overløp	a passage or outlet through which surplus water flows over, around or through a dam
S.SQR	plass	a broad, open, public area near the center of a town or city
S.STBL	stall	a building for the shelter and feeding of farm animals, especially horses
S.STDM	stadion	a structure with an enclosure for athletic games with tiers of seats for spectators
S.STNB	forskningsbase	a scientific facility used as a base from which research is carried out or monitored
S.STNC	kystvaktstasjon	a facility from which the coast is guarded by armed vessels
S.STNE	eksperimentstasjon	a facility for carrying out experiments
S.STNF	skogstasjon	a collection of buildings and facilities for carrying out forest management
S.STNI	inspeksjonsstasjon	a station at which vehicles, goods, and people are inspected
S.STNM	meteorologisk stasjon	a station at which weather elements are recorded
S.STNR	radiostasjon	a facility for producing and transmitting information by radio waves
S.STNS	satellittstasjon	a facility for tracking and communicating with orbiting satellites
S.STNW	hvalfangststasjon	a facility for butchering whales and processing train oil
S.STPS	trinn	stones or slabs placed for ease in ascending or descending a steep slope
S.SWT	sewage treatment plant	facility for the processing of sewage and/or wastewater
S.THTR	teater	A building, room, or outdoor structure for the presentation of plays, films, or other dramatic performances
S.TMB	grav	a structure for interring bodies
S.TMPL	tempel	an edifice dedicated to religious worship
S.TNKD	desinfeksjonsstasjon for kveg	a small artificial pond used for immersing cattle in chemically treated water for disease control
S.TOWR	tårn	a high conspicuous structure, typically much higher than its diameter
S.TRANT	transit terminal	facilities for the handling of vehicular freight and passengers
S.TRIG	trianguleringsstasjon	a point on the earth whose position has been determined by triangulation
S.TRMO	terminal for oljerørledning	a tank farm or loading facility at the end of an oil pipeline
S.TWO	Temp Work Office	Temporary Work Offices
S.UNIO	postgrad & MBA	Post Universitary Education Institutes (post graduate studies and highly specialised master programs) & MBA
S.UNIP	University Prep School	University Preparation Schools & Institutions
S.UNIV	universitet	An institution for higher learning with teaching and research facilities constituting a graduate school and professional schools that award master's degrees and doctorates and an undergraduate division that awards bachelor's degrees.
S.USGE	anlegg tilhørende USA	a facility operated by the United States Government in Panama
S.VETF	veterinæranlegg	a building or camp at which veterinary services are available
S.WALL	mur	a thick masonry structure, usually enclosing a field or building, or forming the side of a structure
S.WALLA	fortidsmur	the remains of a linear defensive stone structure
S.WEIR	fiskedam	a small dam in a stream, designed to raise the water level or to divert stream flow through a desired channel
S.WHRF	kai	a structure of open rather than solid construction along a shore or a bank which provides berthing for ships and cargo-handling facilities
S.WRCK	vrak	the site of the remains of a wrecked vessel
S.WTRW	vannverk	a facility for supplying potable water through a water source and a system of pumps and filtration beds
S.ZNF	frihandelssone	an area, usually a section of a port, where goods may be received and shipped free of customs duty and of most customs regulations
S.ZOO	dyrehage	a zoological garden or park where wild animals are kept for exhibition
T.ASPH	asfaltsjø	a small basin containing naturally occurring asphalt
T.ATOL	atoll	a ring-shaped coral reef which has closely spaced islands on it encircling a lagoon
T.BAR	bar	a shallow ridge or mound of coarse unconsolidated material in a stream channel, at the mouth of a stream, estuary, or lagoon and in the wave-break zone along coasts
T.BCH	strand	a shore zone of coarse unconsolidated sediment that extends from the low-water line to the highest reach of storm waves
T.BCHS	strender	a shore zone of coarse unconsolidated sediment that extends from the low-water line to the highest reach of storm waves
T.BDLD	steinørken	an area characterized by a maze of very closely spaced, deep, narrow, steep-sided ravines, and sharp crests and pinnacles
T.BLDR	steinmark	a high altitude or high latitude bare, flat area covered with large angular rocks
T.BLHL	luftehull	a hole in coastal rock through which sea water is forced by a rising tide or waves and spurted through an outlet into the air
T.BLOW	utblåsning	a small depression in sandy terrain, caused by wind erosion
T.BNCH	benk	a long, narrow bedrock platform bounded by steeper slopes above and below, usually overlooking a waterbody
T.BUTE	høyde med bratte sider	a small, isolated, usually flat-topped hill with steep sides
T.CAPE	nes	a land area, more prominent than a point, projecting into the sea and marking a notable change in coastal direction
T.CFT	kløft	a deep narrow slot, notch, or groove in a coastal cliff
T.CLDA	caldera	a depression measuring kilometers across formed by the collapse of a volcanic mountain
T.CLF	klippe	a high, steep to perpendicular slope overlooking a waterbody or lower area
T.CNYN	canyon	a deep, narrow valley with steep sides cutting into a plateau or mountainous area
T.CONE	kjegle	a conical landform composed of mud or volcanic material
T.CRDR	korridor	a strip or area of land having significance as an access way
T.CRQ	dalgryte	a bowl-like hollow partially surrounded by cliffs or steep slopes at the head of a glaciated valley
T.CRQS	dalgryter	bowl-like hollows partially surrounded by cliffs or steep slopes at the head of a glaciated valley
T.CRTR	krater	a generally circular saucer or bowl-shaped depression caused by volcanic or meteorite explosive action
T.CUET	cuesta	an asymmetric ridge formed on tilted strata
T.DLTA	delta	a flat plain formed by alluvial deposits at the mouth of a stream
T.DPR	fordypning	a low area surrounded by higher land and usually characterized by interior drainage
T.DSRT	ørken	a large area with little or no vegetation due to extreme environmental conditions
T.DUNE	sanddyne	a wave form, ridge or star shape feature composed of sand
T.DVD	vannskille	a line separating adjacent drainage basins
T.ERG	sandørken	an extensive tract of shifting sand and sand dunes
T.FAN	avleiringsvifte	a fan-shaped wedge of coarse alluvium with apex merging with a mountain stream bed and the fan spreading out at a low angle slope onto an adjacent plain
T.FORD	vadested	a shallow part of a stream which can be crossed on foot or by land vehicle
T.FSR	revne	a crack associated with volcanism
T.GAP	kløft	a low place in a ridge, not used for transportation
T.GRGE	juv	a short, narrow, steep-sided section of a stream valley
T.HDLD	pynt	a high projection of land extending into a large body of water beyond the line of the coast
T.HLL	ås	a rounded elevation of limited extent rising above the surrounding land with local relief of less than 300m
T.HLLS	åser	rounded elevations of limited extent rising above the surrounding land with local relief of less than 300m
T.HMCK	hammock (stykker av hevet land)	a patch of ground, distinct from and slightly above the surrounding plain or wetland. Often occurs in groups
T.HMDA	steinørken	a relatively sand-free, high bedrock plateau in a hot desert, with or without a gravel veneer
T.INTF	land mellom to elver	a relatively undissected upland between adjacent stream valleys
T.ISL	øy	a tract of land, smaller than a continent, surrounded by water at high water
T.ISLF	kunstig øy	an island created by landfill or diking and filling in a wetland, bay, or lagoon
T.ISLM	mangroveøy	a mangrove swamp surrounded by a waterbody
T.ISLS	øyer	tracts of land, smaller than a continent, surrounded by water at high water
T.ISLT	øy med landforbindelse	a coastal island connected to the mainland by barrier beaches, levees or dikes
T.ISLX	del av øy	
T.ISTH	landtunge	a narrow strip of land connecting two larger land masses and bordered by water
T.KRST	karstområde	a distinctive landscape developed on soluble rock such as limestone characterized by sinkholes, caves, disappearing streams, and underground drainage
T.LAVA	lavaområde	an area of solidified lava
T.LEV	demning	a natural low embankment bordering a distributary or meandering stream; often built up artificially to control floods
T.MESA	mesa	a flat-topped, isolated elevation with steep slopes on all sides, less extensive than a plateau
T.MND	voll	a low, isolated, rounded hill
T.MRN	morene	a mound, ridge, or other accumulation of glacial till
T.MT	fjell	an elevation standing high above the surrounding area with small summit area, steep slopes and local relief of 300m or more
T.MTS	fjell	a mountain range or a group of mountains or high ridges
T.NKM	meanderhals	a narrow strip of land between the two limbs of a meander loop at its narrowest point
T.NTK	nunatak	a rock or mountain peak protruding through glacial ice
T.NTKS	nunatakker	rocks or mountain peaks protruding through glacial ice
T.PAN	aurhelle	a near-level shallow, natural depression or basin, usually containing an intermittent lake, pond, or pool
T.PANS	aurheller	a near-level shallow, natural depression or basin, usually containing an intermittent lake, pond, or pool
T.PASS	pass	a break in a mountain range or other high obstruction, used for transportation from one side to the other [See also gap]
T.PEN	halvøy	an elongate area of land projecting into a body of water and nearly surrounded by water
T.PENX	del av halvøy	
T.PK	tind	a pointed elevation atop a mountain, ridge, or other hypsographic feature
T.PKS	tinder	pointed elevations atop a mountain, ridge, or other hypsographic features
T.PLAT	platå	an elevated plain with steep slopes on one or more sides, and often with incised streams
T.PLATX	del av platå	
T.PLDR	polder	an area reclaimed from the sea by diking and draining
T.PLN	sletteland	an extensive area of comparatively level to gently undulating land, lacking surface irregularities, and usually adjacent to a higher area
T.PLNX	del av slette	
T.PROM	tange	a bluff or prominent hill overlooking or projecting into a lowland
T.PT	odde	a tapering piece of land projecting into a body of water, less prominent than a cape
T.PTS	odder	tapering pieces of land projecting into a body of water, less prominent than a cape
T.RDGB	strandrygg	a ridge of sand just inland and parallel to the beach, usually in series
T.RDGE	rygg	a long narrow elevation with steep sides, and a more or less continuous crest
T.REG	steinørken	a desert plain characterized by a surface veneer of gravel and stones
T.RK	stein	a conspicuous, isolated rocky mass
T.RKFL	steinras	an irregular mass of fallen rock at the base of a cliff or steep slope
T.RKS	klipper	conspicuous, isolated rocky masses
T.SAND	sandområde	a tract of land covered with sand
T.SBED	tørt elveleie	a channel formerly containing the water of a stream
T.SCRP	bratt skråning	a long line of cliffs or steep slopes separating level surfaces above and below
T.SDL	sal	a broad, open pass crossing a ridge or between hills or mountains
T.SHOR	bredd	a narrow zone bordering a waterbody which covers and uncovers at high and low water, respectively
T.SINK	jordfallshull	a small crater-shape depression in a karst area
T.SLID	ras	a mound of earth material, at the base of a slope and the associated scoured area
T.SLP	kontinentalskråning	a surface with a relatively uniform slope angle
T.SPIT	tange	a narrow, straight or curved continuation of a beach into a waterbody
T.SPUR	utspring	a subordinate ridge projecting outward from a hill, mountain or other elevation
T.TAL	steinur	a steep concave slope formed by an accumulation of loose rock fragments at the base of a cliff or steep slope
T.TRGD	dal mellom sanddyner	a long wind-swept trough between parallel longitudinal dunes
T.TRR	terrasse	a long, narrow alluvial platform bounded by steeper slopes above and below, usually overlooking a waterbody
T.UPLD	oppland	an extensive interior region of high land with low to moderate surface relief
T.VAL	dal	an elongated depression usually traversed by a stream
T.VALG	hengende dal	a valley the floor of which is notably higher than the valley or shore to which it leads; most common in areas that have been glaciated
T.VALS	daler 	elongated depressions usually traversed by a stream
T.VALX	del av dal	
T.VLC	vulkan	a conical elevation composed of volcanic materials with a crater at the top
U.APNU	slette	a gentle slope, with a generally smooth surface, particularly found around groups of islands and seamounts
U.ARCU	bue	a low bulge around the southeastern end of the island of Hawaii
U.ARRU	arrugado	an area of subdued corrugations off Baja California
U.BDLU	grenseområde	a region adjacent to a continent, normally occupied by or bordering a shelf, that is highly irregular with depths well in excess of those typical of a shelf
U.BKSU	bredd	elevations, typically located on a shelf, over which the depth of water is relatively shallow but sufficient for safe surface navigation
U.BNCU	avsats	a small terrace
U.BNKU	bredd	an elevation, typically located on a shelf, over which the depth of water is relatively shallow but sufficient for safe surface navigation
U.BSNU	basseng	a depression more or less equidimensional in plan and of variable extent
U.CDAU	fjellkjede	an entire mountain system including the subordinate ranges, interior plateaus, and basins
U.CNSU	canyoner	relatively narrow, deep depressions with steep sides, the bottom of which generally has a continuous slope
U.CNYU	canyon	a relatively narrow, deep depression with steep sides, the bottom of which generally has a continuous slope
U.CRSU	kontinentalstigning	a gentle slope rising from oceanic depths towards the foot of a continental slope
U.DEPU	dyp	a localized deep area within the confines of a larger feature, such as a trough, basin or trench
U.EDGU	kontinentalsokkelkant	a line along which there is a marked increase of slope at the outer margin of a continental shelf or island shelf
U.ESCU	bratt skråning	an elongated and comparatively steep slope separating flat or gently sloping areas
U.FANU	avleiringsvifte	a relatively smooth feature normally sloping away from the lower termination of a canyon or canyon system
U.FLTU	flate	a small level or nearly level area
U.FRKU	kløft	a branch of a canyon or valley
U.FRSU	kløfter	a branch of a canyon or valley
U.FRZU	bruddsone	an extensive linear zone of irregular topography of the sea floor, characterized by steep-sided or asymmetrical ridges, troughs, or escarpments
U.FURU	fure	a closed, linear, narrow, shallow depression
U.GAPU	passasje	a narrow break in a ridge or rise
U.GLYU	renne	a small valley-like feature
U.HLLU	ås	an elevation rising generally less than 500 meters
U.HLSU	åser	elevations rising generally less than 500 meters
U.HOLU	hull	a small depression of the sea floor
U.KNLU	knaus 	an elevation rising generally more than 500 meters and less than 1,000 meters and of limited extent across the summit
U.KNSU	knauser	elevations rising generally more than 500 meters and less than 1,000 meters and of limited extent across the summits
U.LDGU	avsats	a rocky projection or outcrop, commonly linear and near shore
U.LEVU	demning	an embankment bordering a canyon, valley, or seachannel
U.MDVU	riftdal	the axial depression of the mid-oceanic ridge system
U.MESU	mesa	an isolated, extensive, flat-topped elevation on the shelf, with relatively steep sides
U.MNDU	voll 	a low, isolated, rounded hill
U.MOTU	vollgrav	an annular depression that may not be continuous, located at the base of many seamounts, islands, and other isolated elevations
U.MTSU	fjell	well-delineated subdivisions of a large and complex positive feature
U.MTU	fjell	a well-delineated subdivision of a large and complex positive feature
U.PKSU	topper	prominent elevations, part of a larger feature, either pointed or of very limited extent across the summit
U.PKU	topp	a prominent elevation, part of a larger feature, either pointed or of very limited extent across the summit
U.PLFU	plattform	a flat or gently sloping underwater surface extending seaward from the shore
U.PLNU	slette	a flat, gently sloping or nearly level region
U.PLTU	platå	a comparatively flat-topped feature of considerable extent, dropping off abruptly on one or more sides
U.PNLU	tind	a high tower or spire-shaped pillar of rock or coral, alone or cresting a summit
U.PRVU	provins	a region identifiable by a group of similar physiographic features whose characteristics are markedly in contrast with surrounding areas
U.RAVU	ravine	a small canyon
U.RDGU	rygg	a long narrow elevation with steep sides
U.RDSU	rygger	long narrow elevations with steep sides
U.RFSU	rev	surface-navigation hazards composed of consolidated material
U.RFU	rev	a surface-navigation hazard composed of consolidated material
U.RISU	stigning	a broad elevation that rises gently, and generally smoothly, from the sea floor
U.RMPU	skråning	a gentle slope connecting areas of different elevations
U.RNGU	åpent lende	a series of associated ridges or seamounts
U.SCNU	sjøkanal	a continuously sloping, elongated depression commonly found in fans or plains and customarily bordered by levees on one or two sides
U.SCSU	sjøkanaler	continuously sloping, elongated depressions commonly found in fans or plains and customarily bordered by levees on one or two sides
U.SDLU	sal	a low part, resembling in shape a saddle, in a ridge or between contiguous seamounts
U.SHFU	hylle	a zone adjacent to a continent (or around an island) that extends from the low water line to a depth at which there is usually a marked increase of slope towards oceanic depths
U.SHLU	sandgrunne	a surface-navigation hazard composed of unconsolidated material
U.SHSU	sandgrunner	hazards to surface navigation composed of unconsolidated material
U.SHVU	dal gjennom kontinentalhyllen	a valley on the shelf, generally the shoreward extension of a canyon
U.SILU	terskel	the low part of a gap or saddle separating basins
U.SLPU	skråning	the slope seaward from the shelf edge to the beginning of a continental rise or the point where there is a general reduction in slope
U.SMSU	undersjøiske fjell	elevations rising generally more than 1,000 meters and of limited extent across the summit
U.SMU	undersjøisk fjell	an elevation rising generally more than 1,000 meters and of limited extent across the summit
U.SPRU	utspring	a subordinate elevation, ridge, or rise projecting outward from a larger feature
U.TERU	terrasse	a relatively flat horizontal or gently inclined surface, sometimes long and narrow, which is bounded by a steeper ascending slope on one side and by a steep descending slope on the opposite side
U.TMSU	guyoter	seamounts having a comparatively smooth, flat top
U.TMTU	guyot 	a seamount having a comparatively smooth, flat top
U.TNGU	landtunge	an elongate (tongue-like) extension of a flat sea floor into an adjacent higher feature
U.TRGU	gjennomgang	a long depression of the sea floor characteristically flat bottomed and steep sided, and normally shallower than a trench
U.TRNU	renne	a long, narrow, characteristically very deep and asymmetrical depression of the sea floor, with relatively steep sides
U.VALU	dal 	a relatively shallow, wide depression, the bottom of which usually has a continuous gradient
U.VLSU	daler 	a relatively shallow, wide depression, the bottom of which usually has a continuous gradient
V.BUSH	busk	a small clump of conspicuous bushes in an otherwise bare area
V.CULT	dyrket mark	an area under cultivation
V.FRST	skog	an area dominated by tree vegetation
V.FRSTF	forsteinet skog	a forest fossilized by geologic processes and now exposed at the earth's surface
V.GRSLD	gresslette	an area dominated by grass vegetation
V.GRVC	kokospalmelund	a planting of coconut trees
V.GRVO	olivenlund	a planting of olive trees
V.GRVP	palmelund	a planting of palm trees
V.GRVPN	furulund	a planting of pine trees
V.HTH	hei	an upland moor or sandy area dominated by low shrubby vegetation including heather
V.MDW	eng	a small, poorly drained area dominated by grassy vegetation
V.OCH	frukthage	a planting of fruit or nut trees
V.SCRB	krattskog	an area of low trees, bushes, and shrubs stunted by some environmental limitation
V.TREE	tre 	a conspicuous tree used as a landmark
V.TUND	tundra	a marshy, treeless, high latitude plain, dominated by mosses, lichens, and low shrub vegetation under permafrost conditions
V.VIN	vingård 	a planting of grapevines
V.VINS	vingårder	plantings of grapevines
null	not available	
